1 1 1 1 1 1 1 1 1 1 1 1 1 1 1 1 1 1 1 1 
1 6 6 6 6 6 6 6 1 2 3 1 6 6 6 6 6 6 6 1 
1 6 6 6 6 6 6 6 1 6 6 1 6 6 6 6 6 6 6 1 
1 6 6 6 6 6 6 6 1 6 6 1 6 6 6 6 6 6 6 1 
1 6 6 6 6 6 6 6 1 6 6 1 6 6 6 6 6 6 6 1 
1 6 6 6 6 6 6 6 1 6 6 1 6 6 6 6 6 6 6 1 
1 6 6 6 6 6 6 5 1 6 6 1 5 6 6 6 6 6 6 1 
1 12 1 1 1 1 1 1 1 6 6 1 1 1 1 1 1 13 1 1 
1 5 6 6 6 6 6 6 6 6 6 6 6 6 6 6 6 6 6 1 
1 6 6 6 6 6 6 6 6 6 6 6 6 6 6 6 6 6 6 1 
1 6 6 6 6 6 6 6 6 6 6 6 6 6 6 6 6 6 6 1 
1 6 6 6 6 6 6 6 6 6 6 6 6 6 6 6 6 6 5 1 
1 13 1 1 1 1 1 1 1 6 6 1 1 1 1 1 1 12 1 1 
1 6 6 6 6 6 6 5 1 6 6 1 5 6 6 6 6 6 6 1 
1 6 6 6 6 6 6 6 1 6 6 1 6 6 6 6 6 6 6 1 
1 6 6 6 6 6 6 6 1 6 6 1 6 6 6 6 6 6 6 1 
1 6 6 6 6 6 6 6 1 6 6 1 6 6 6 6 6 6 6 1 
1 6 6 6 6 6 6 6 1 6 6 1 6 6 6 6 6 6 6 1 
1 6 6 6 6 6 6 6 1 4 4 1 6 6 6 6 6 6 6 1 
1 1 1 1 1 1 1 1 1 1 1 1 1 1 1 1 1 1 1 1
