1 1 1 1 1 1 1 1 1 1 1 1 1 1 1 1 1 9 9 9 
1 3 0 0 0 0 0 0 0 0 0 0 0 0 0 0 0 0 0 9 
1 2 0 0 0 0 0 0 0 0 0 0 0 0 0 0 0 0 0 9
1 1 1 1 1 1 1 1 1 1 1 1 1 1 9 9 9 0 0 1 
1 7 7 0 0 0 0 0 0 0 0 0 0 0 0 0 9 0 0 1 
1 7 7 0 0 0 0 0 0 0 0 0 0 0 0 0 9 0 0 1 
1 0 0 1 1 1 1 1 1 1 1 9 9 9 0 0 1 0 0 1 
1 0 0 1 7 7 0 0 0 0 0 0 0 9 0 0 1 0 0 1 
1 0 0 1 7 7 0 0 0 0 0 0 0 9 0 0 1 0 0 1 
1 0 0 1 0 0 1 1 1 1 1 0 0 1 0 0 1 0 0 1 
1 0 0 1 0 0 1 4 4 0 0 0 0 1 0 0 1 0 0 1 
1 0 0 1 0 0 1 4 4 0 0 0 0 1 0 0 1 0 0 1 
1 0 0 1 0 0 1 4 4 0 0 0 0 1 0 0 1 0 0 1 
1 0 0 1 0 0 1 1 1 1 1 1 1 1 0 0 1 0 0 1 
1 0 0 9 0 0 0 0 0 0 0 0 0 0 7 7 1 0 0 1 
1 0 0 9 0 0 0 0 0 0 0 0 0 0 7 7 1 0 0 1 
1 0 0 9 9 9 1 1 1 1 1 1 1 1 1 1 1 0 0 1 
9 0 0 0 0 0 0 0 0 0 0 0 0 0 0 0 0 7 7 1 
9 0 0 0 0 0 0 0 0 0 0 0 0 0 0 0 0 7 7 1 
9 9 9 1 1 1 1 1 1 1 1 1 1 1 1 1 1 1 1 1